credit bureau	신용조사기관
personal check	개인 수표
enclosed	동봉된
enclose	동봉하다, 둘러싸다
make a speech	연설하다
so far	지금까지
executive	경영진, 실행의
execution	실행
hold	개최하다
reception	환영
be on the phone	통화중이다
master's degree	석사 학위
doctorate	박사 학위
bachelor	학사
grant	보조금
demonstration	시연
draft	원고
once	~하자마자, ~할 때
board	이사회
banquet	파티, 연회
by the time	~할 때에
investor	투자자
corporate	기업의
alleviate	감소시키다, 줄이다
state-of-the-art	최첨단의
fine line	잔주름
accommodate	수용하다
renovate	개조하다
opportunity	기회